1111111111111111111111111111
1P00000001111C00000000000111
1E00000000000000000000000011
1100000100001000000111111111
1110000000000C00000000011111
1111111111111111111111111111
