1111111
1PCE001
1111111
1111o1
1111111












