111111111111111111111
1CCCC0000CCCC00000011
1CCCC0000CCCC00000011
1CCCC0000CCCC00000011
1CCCC0000CCCC00000011
10000CCCC0000CCCC0011
10000CCCC0000CCCC0011
10000CCCC0000CCCC0011
10000CCCC0000CCCC0011
100000000000000000011
100000000000000000011
1000000000000E0000011
100000000000000000011
111100000000000000011
1100000000000000P0C11
111111111111111111111
111111111111111111111
