1111111111111111111
11110C11110000000P1
10000E1111000000001
1000000000000000001
1111111111111111111
1100000000000000111
1111111111111111111
